0015 0015
0007 0002
333333333333333
300000000000003
300000000000003
300110000011003
300110000011003
300000000000003
300000020000003
300000222000003
300000020000003
300000000000003
300110000011003
300110000011003
300000000000003
300000000000003
333333333333333