111111111111111
100000000000001
100000000000001
100110000011001
100110000011001
100000000000001
100000020000001
100000222000001
100000020000001
100000000000001
100110000011001
100110000011001
100000000000001
100000000000001
111111111111111